11111111111111111111111111
100C1000000C0000C10C000001
10010000000000001000000C01
100000111C000001C000010001
10P001EC0000C00000C0000001
11111111111111111111111111