1111111111111
10000000000C1
10P0001111001
100001E000001
1111111111111