1111111111111
10000000000C1
1000001111001
100001E000001
11P1111111111