1111111111111111111111111111111111111111
1000000000000000000000000000000000000001
10000000000000000000000C0000000000000001
1000000C00000000011000000000000000000001
1000000000000000011000000000000000000001
1000000000000000011000000000000000000001
100000000000000111111000000000C000000001
1000000C00000001111110000000000000000001
1000000000000000000000000000000000000001
1000000000000000000000000000000000000001
1000000000000000000000000000000000000001
1000000000000000000000000000000000000001
100000000000000000000000000000C000000001
1000000000000000000000000000000000000001
1000000000000000000000000000000000000001
1000000P00000000C00000000000000000000001
1111111111111111111111111111111111111111
