1111111111111111111111111111111111111111111111111111
10000000000000000000000P0000000000000000000000000001
1000000000000000000000000000000000000000000000000001
10000C0000000000000000000000000000000000000000000001
100000000000C0000000000000000000000C0000000000000001
1000000000000000000000000000000000000000000000000001
10000C00000000000000000E0000000000000000000000000001
100000000000C000000000000000000000000000000000000001
1000000000000000000000000000000000000000000000000001
10000C000000C000000000000000000000000000000000000001
1000000000000000000000000000000000000000000000000001
1000000000000000000000000000000000000000000000000001
10000C0000000000000000C000000000000C0000000000000001
1000000000000000000000000000000000000000000000000001
1111111111111111111111111111111111111111111111111111